........
........
..b..y..
........
........
..g..r..
........
........