.........oro.........
.........oro.........
.........oro.........
.........oro.........
.........oro.........
.........oro.........
.........oro.........
.........oro.........
.........oro.........
.........oro.........
.........oro.........
.........brb.........
.........bbb.........