...gggoggg...
....ggogg....
.....gog.....
b.....o.....r
bb....o....rr
bbb..ooo..rrr
oooooo.oooooo
bbb..ooo..rrr
bb....o....rr
b.....o.....r
.....yoy.....
....yyoyy....
...yyyoyyy...